#########
#.....#.#
#.###..T#
#..#..#.#
#.#######
#..#..P.#
#.##.##.#
#.....#.#
#########